R 640 480
NO ./res/bluestone.xpm
SO ./res/greystone.xpm
WE ./res/redbrick.xpm
EA ./res/mossy.xpm
S ./res/barrel.xpm
C 2,100,255
F 100,100,100
11111111111111111111111111111
11111111111111111111111111
110001S1000000000000000
10110111011100000000000010001
10010000000000000000000010001
10110000011100000000000010001
10000100001100000111011110001
11110000001111011100000010001
11110111111111011101010010001
11000000110101011100000010001
10012100000000001100000010001
10002000000000001101010010001
11000001110101011111011110001
1111011 111101011111011110001
1111111 111111111111111111111