R 640 480
NO ./res/bluestone.xpm
SO ./res/greystone.xpm
WE ./res/redbrick.xpm
EA ./res/mossy.xpm
S ./res/barrel.xpm
C 2,100,255
F 100,100,100
1111111
11E0001
1011201
1001001
1111111