R 640 480
F 100,100,100
C 2,100,255
S ./res/barrel.xpm
NO ./res/bluestone.xpm
SO ./res/greystone.xpm
EA ./res/mossy.xpm
WE ./res/redbrick.xpm
11111111
11E0000100001
1011001000 01
11100010
1111111111