R 1920 1080
NO /Users/mroux/42Cursus/cub3d/repo/srcs/playground/bluestone.xpm
SO /Users/mroux/42Cursus/cub3d/repo/srcs/playground/greystone.xpm
WE /Users/mroux/42Cursus/cub3d/repo/srcs/playground/redbrick.xpm
EA /Users/mroux/42Cursus/cub3d/repo/srcs/playground/mossy.xpm
S /Users/mroux/42Cursus/cub3d/repo/srcs/playground/redbrick.xpm
F 220,100,0
C 225,30,0
111111111111111111111111
100000000011000000000000
101100000111000000200000
100100000000000000000000
101100000111000000000000
100000000011000001110111
111101111111110111000000
111101111111110111010100
110000001101010111000000
100020000000000011000000
100000000000000011010100
110000001101010111110111
111101111111010111110111
101100000111000000200000
100100000000000000000000
101100000111000000000000
100000000011000001110111
111101111111110111000000
111101111111110111010100
110000001101010111000000
100020000000000011000000
100000000000000011010100
110000001101010111110111
111101111111010111110111
111111111111111111111111